{
  "grid": {
    "columns": 31,
    "rows": 13,
    "cellSize": 32
  },
  "origin": {
    "x": 16,
    "y": 80
  },
  "tiles": [
    "###############################",
    "#1...........................E#",
    "#.#.#.#.#.#.#.#.#.#.#.#.#.#.#.#",
    "#.B.B.B.B.B.B.B.B.B.B.B.B.B.B.#",
    "#.#.#.#.#.#.#.#.#.#.#.#.#.#.#.#",
    "#.B.B.B.B.B.B.B.B.B.B.B.B.B.B.#",
    "#.#.#.#.#.#.#.#.#.#.#.#.#.#.#.#",
    "#.B.B.B.B.B.B.B.B.B.B.B.B.B.B.#",
    "#.#.#.#.#.#.#.#.#.#.#.#.#.#.#.#",
    "#.B.B.B.B.B.B.B.B.B.B.B.B.B.B.#",
    "#.#.#.#.#.#.#.#.#.#.#.#.#.#.#.#",
    "#............................2#",
    "###############################"
  ]
}
