{
    "grid": {"columns": 31, "rows": 13, "cellSize": 32},
    "origin": {"x": 16, "y": 80},
    "tiles": [
        "###############################",
        "#1............................#",
        "#.#.#.#.#.#.#.#.#.#.#.#.#.#.#.#",
        "#.B.B.B.B.B.B.B.B.B.B.B.B.B.B.#",
        "#.#.#.#.#.#.#.#.#.#.#.#.#.#.#.#",
        "#.B.B.B.B.B.B.B.B.B.B.B.B.B.B.#",
        "#.#.#.#.#.#.#.#.#.#.#.#.#.#.#.#",
        "#.B.B.B.B.B.B.B.E.B.B.B.B.B.B.#",
        "#.#.#.#.#.#.#.#.#.#.#.#.#.#.#.#",
        "#.B.B.B.B.B.B.B.B.B.B.B.B.B.B.#",
        "#.#.#.#.#.#.#.#.#.#.#.#.#.#.#.#",
        "#............................2#",
        "###############################"
    ]
}
